\LLLLLLLLLLLLL\
\[[[[[[[\
\L[L[L[L[L[L\
\[[[[[[[[[[[\
\[L[L[L[L[L[L[\
\[[[[[[[[[[[[[\
\[L[L[L[L[L[L[\
\[[[[[[[[[[[[[\
\[L[L[L[L[L[L[\
\[[[[[[[[[[[\
\L[L[L[L[L[L\
\[[[[[[[\
LLLLLLLLLLLLLLL